111111111111111
1111100C000C0P1
111110E11111111
111000100001111
111111111111111