111111111111111
11111100E00C0P1
111111111111111